2 6 4 1 1 0
2 4 2 2 5 2
2 3 1 2 7 1
2 7 0 2 101 0
2 2 4 1 0 0
1 0 0 2 2 4
2 7 1 2 3 1
1 1 0 2 6 4
2 4 0 2 100 0
2 5 2 2 4 2
2 101 0 2 7 0
2 100 0 2 4 0
